1111111111
1000000001
1000000001
1000100001
1000110001
1000010001
1000001101
1000000101
1111111101
1001000001
1001011111
1000010$01
1000010001
1000000001
1111111111
